T.##..S..T
ST##..###.
#.###E###E
#.E...###.
###T#####G
