T.##.....T
ST##..###.
#.###E###E
#.E...###.
###T#####G
